
NO           textures/wall1.xpm
SO textures/wall2.xpm
WE textures/wall3.xpm
EA textures/wall4.xpm



F           0,0,1
C  225,30,1


111111111 11111
11100N111 111111
111111111 1111111
11111       1111111
111111       1111111
1111         1111111
11111111111111111111