NO 	textures/wall1.xpm
SO textures/wall2.xpm
WE textures/wall3.xpm
EA textures/wall4.xpm





C 225,0,1
F  0,0,255


11111111 111
1100N111110011111111
111111 111111 1111111